XXXXXXXXXXXXXXXXSXXXXXXXX
X  X X         X X      X
X XX XX XXXX XXX X  X X X
X  X       X     XX X XXX
X XXXXXXXX XXX XXX  X   X
X          X       XXXX X
XXXXX X XXXX XXXXXXX  X X
X   X X X  X X        XXX
X X X XXX XX   XXX XX   X
X X          XXX X  XXX X
X XXX XXXXXX X   XX X X X
X  X  X    X X X  X X   X
XX XXXX XXXX   XX X XXXXX
XX         XXX  X X     X
X  XXXXXXXXX XX X XXXXXXX
X XX   X      X X  X    X
X X  XXX XX X X XXXX X  X
X X XX    X X X X    XX X
X X XXXXX X XXXXXXXX  X X
X   X   X X X         X X
XXX X X X X X XXXXXXXXX X
X   X X X X X      X  X X
X XXX X X X XXXXXX X XX X
X     X   X        X    X
XXXXXXXXXXXXXXXXXXXXXXXEX