XXXXXXXXXXXXXXXXXXXXXXXXXXXXXXXXS XXXXXXXXXXXXXXXX
XXXXXXXXXXXXXXXXXXXXXXXXXXXXXXXX  XXXXXXXXXXXXXXXX
XX    XX  XX                  XX  XX            XX
XX    XX  XX                  XX  XX            XX
XX  XXXX  XXXX  XXXXXXXX  XXXXXX  XX    XX  XX  XX
XX  XXXX  XXXX  XXXXXXXX  XXXXXX  XX    XX  XX  XX
XX    XX              XX          XXXX  XX  XXXXXX
XX    XX              XX          XXXX  XX  XXXXXX
XX  XXXXXXXXXXXXXXXX  XXXXXX  XXXXXX    XX      XX
XX  XXXXXXXXXXXXXXXX  XXXXXX  XXXXXX    XX      XX
XX                    XX              XXXXXXXX  XX
XX                    XX              XXXXXXXX  XX
XXXXXXXXXX  XX  XXXXXXXX  XXXXXXXXXXXXXX    XX  XX
XXXXXXXXXX  XX  XXXXXXXX  XXXXXXXXXXXXXX    XX  XX
XX      XX  XX  XX    XX  XX                XXXXXX
XX      XX  XX  XX    XX  XX                XXXXXX
XX  XX  XX  XXXXXX  XXXX      XXXXXX  XXXX      XX
XX  XX  XX  XXXXXX  XXXX      XXXXXX  XXXX      XX
XX  XX                    XXXXXX  XX    XXXXXX  XX
XX  XX                    XXXXXX  XX    XXXXXX  XX
XX  XXXXXX  XXXXXXXXXXXX  XX      XXXX  XX  XX  XX
XX  XXXXXX  XXXXXXXXXXXX  XX      XXXX  XX  XX  XX
XX    XX    XX        XX  XX  XX    XX  XX      XX
XX    XX    XX        XX  XX  XX    XX  XX      XX
XXXX  XXXXXXXX  XXXXXXXX      XXXX  XX  XXXXXXXXXX
XXXX  XXXXXXXX  XXXXXXXX      XXXX  XX  XXXXXXXXXX
XXXX                  XXXXXX    XX  XX          XX
XXXX                  XXXXXX    XX  XX          XX
XX    XXXXXXXXXXXXXXXXXX  XXXX  XX  XXXXXXXXXXXXXX
XX    XXXXXXXXXXXXXXXXXX  XXXX  XX  XXXXXXXXXXXXXX
XX  XXXX      XX            XX  XX    XX        XX
XX  XXXX      XX            XX  XX    XX        XX
XX  XX    XXXXXX  XXXX  XX  XX  XXXXXXXX  XX    XX
XX  XX    XXXXXX  XXXX  XX  XX  XXXXXXXX  XX    XX
XX  XX  XXXX        XX  XX  XX  XX        XXXX  XX
XX  XX  XXXX        XX  XX  XX  XX        XXXX  XX
XX  XX  XXXXXXXXXX  XX  XXXXXXXXXXXXXXXX    XX  XX
XX  XX  XXXXXXXXXX  XX  XXXXXXXXXXXXXXXX    XX  XX
XX      XX      XX  XX  XX                  XX  XX
XX      XX      XX  XX  XX                  XX  XX
XXXXXX  XX  XX  XX  XX  XX  XXXXXXXXXXXXXXXXXX  XX
XXXXXX  XX  XX  XX  XX  XX  XXXXXXXXXXXXXXXXXX  XX
XX      XX  XX  XX  XX  XX            XX    XX  XX
XX      XX  XX  XX  XX  XX            XX    XX  XX
XX  XXXXXX  XX  XX  XX  XXXXXXXXXXXX  XX  XXXX  XX
XX  XXXXXX  XX  XX  XX  XXXXXXXXXXXX  XX  XXXX  XX
XX          XX      XX                XX        XX
XX          XX      XX                XX        XX
XXXXXXXXXXXXXXXXXXXXXXXXXXXXXXXXXXXXXXXXXXXXXX  XX
XXXXXXXXXXXXXXXXXXXXXXXXXXXXXXXXXXXXXXXXXXXXXX EXX